NO inc/north.xpm
EA inc/east.xpm
SO inc/purplestone.xpm
WE inc/west.xpm

C 135,206,235
F 15,6,40

111111111111111
111111000111111
111110000011111
1111000N0001111
111000000000111
11000000000001111
  1100001111100001
11000011100001111
111000010000111
111100000001111
111110000011111
111111000111111
111111111111111
