NO			inc/north.xpm

EA		inc/east.xpm







SO	inc/purplestone.xpm




WE	                            inc/west.xpmmm

C 0,0,0



F 0,0,0

111111111111111
111111000111111
111110000011111
1111000S0001111
111000000000111         111111
110000000000011        11100011
100001111100001         11111
110000111000011
111000010000111
111100000001111
111110000011111
111111000101111
111111111111111