NO textures/simonkraft/respawn_anchor_side0.xpm
EA textures/simonkraft/respawn_anchor_side2.xpm
SO textures/simonkraft/respawn_anchor_side4.xpm
WE textures/simonkraft/respawn_anchor_side3.xpm

C 35,19,73
F 15,6,40

111111111111111             11111
111111000111111             10011
111110000011111             10011
1111000N0001111             10011
111000000000111             11111
110000000000011
100001111100001
110000111000011
111000010000111
111100001111111
111110001011111        11111        111
111111001111111        10001        101
111111111111111        11111        111